###############
...E#a........#
.####.#####.#.#
........#.#....
.########.####.
....#.#........
....#...##...#.
....#.##..#####
.####.#..##....
.#....#.....##S
...#.........a#