###############
XXXE#a........#
X####X#####.#.#
XXXXXX..#.#....
.#######.......
....#..........
....#..........
....#.##..#####
.####.#..##XXXX
.#....#....X##S
...#.......XXa#
