E.............
#######a#####.
..............
......########
..............
......###a##.S