###############
...E#a........#
.####.#####.#.#
........#.#....
.#######.......
....#..........
....#..........
....#.##..#####
.####.#..##....
.#....#.....##S
...#.........a#