###############
XXXE#.........#
X####.#####.#.#
X.......#.#....
X#######.......
X...#..........
X...#..........
X...#.##..#####
X####.#..##XXXX
X#XXXX#....X##S
XXX#.XXXXXXX..#
